e.........
vvvvvvv.vv
........vb
......v.v.
......v.v.
....vvv.v.
........v.
...vvvvvv.
.....v..v.
...v......
